1,-34.0053,34.9544,20.0494,0,0,0,1,1,1,1
1,-33.953,37.198,9.65023,-0.039443,0.212815,-0.177916,0.959948,4,4,4
1,-33.9314,37.2118,-0.287076,0,0,-0.233445,0.97237,3,3,3
1,50,50,50,0,0,0,1,1,1,1
1,-40,50,50,0,0,0,1,1,1,1
1,30,50,-50,0,0,0,1,1,1,1
1,20,50,50,0,0,0,1,1,1,1
1,-10,50,50,0,0,0,1,1,1,1
1,50,40,-50,0,0,0,1,1,1,1
0,-0.0117087,0.9662,-0.00343847,0,0,0,1,300,2,300
